from	to
à	a
á	b
â	v
ã	g
ä	d
å	e
¸	yo
æ	zh
ç	z
è	i
é	j
ê	k
ë	l
ì	m
í	n
î	o
ï	p
ğ	r
ñ	s
ò	t
ó	u
ô	f
õ	h
ö	c
÷	ch
ø	sh
ù	sch
ú	'
û	y
ü	'
ı	e
ş	ju
ÿ	ja
À	A
Á	B
Â	V
Ã	G
Ä	D
Å	E
¨	Yo
Æ	Zh
Ç	Z
È	I
É	J
Ê	K
Ë	L
Ì	M
Í	N
Î	O
Ï	P
Ğ	R
Ñ	S
Ò	T
Ó	U
Ô	F
Õ	H
Ö	C
×	Ch
Ø	Sh
Ù	Sch
Ú	
Û	Y
Ü	
İ	E
Ş	Yu
ß	Ya
¡	b
¢	b
¤	d
¥	e
¦	zh
§	z
ª	k
¬	m
¯	p
€	A
	B
ƒ	G
„	D
†	Zh
‡	Z
Š	K
‹	L
Œ	M
	N
	O
	P
	R
‘	S
’	T
“	U
”	F
º	eur